[
    ["s", "s", "g", "g", "s", "s", "g", "g", "s", "s", "g", "g", "s", "s"],
    ["r", "r", "r", "r", "r", "r", "r", "r", "r", "r", "r", "r", "r", "r"],
    ["r", "g", "g", "g", "g", "g", "g", "g", "r", "f", "f", "f", "f", "r"],
    ["r", "g", "p", "p", "p", "p", "p", "g", "r", "r", "r", "r", "r", "r"],
    ["r", "g", "g", "g", "g", "g", "g", "g", "r", "g", "g", "g", "g", "r"],
    ["r", "0", "0", "0", "0", "0", "0", "0", "r", "g", "p", "h", "g", "r"],
    ["r", "0", "0", "0", "0", "0", "r", "r", "r", "g", "g", "g", "g", "r"],
    ["r", "0", "0", "0", "0", "0", "r", "b", "r", "r", "r", "r", "r", "r"],
    ["r", "0", "0", "0", "0", "0", "r", "b", "r", "s", "r", "s", "s", "r"],
    ["r", "0", "0", "0", "0", "0", "r", "h", "r", "s", "r", "r", "r", "r"],
    ["r", "g", "g", "0", "0", "0", "r", "f", "r", "s", "r", "s", "s", "r"],
    ["r", "p", "m", "m", "0", "0", "r", "f", "r", "s", "r", "s", "s", "r"],
    ["r", "r", "r", "r", "r", "r", "r", "r", "r", "r", "r", "r", "r", "r"],
    ["b", "b", "g", "p", "p", "b", "g", "g", "g", "g", "g", "g", "g", "m"]
]
